BEER	B IH R
COKE	K OW K
HELLO	HH AH L OW
HELLO(2)	HH EH L OW
I	AY
IS	IH Z
LIKE	L AY K
MARGARITA	M AA R G ER IY T AH
NAME?	N EY M
NO	N OW
ORDER	AO R D ER
PEPPER	P EH P ER
SPRITE	S P R AY T
TEQUILA	T AH K IY L AH
TO	T UW
TO(2)	T IH
TO(3)	T AH
WHAT	W AH T
WHAT(2)	HH W AH T
WINE	W AY N
WOULD	W UH D
YES	Y EH S
YOUR	Y AO R
YOUR(2)	Y UH R
